!!ATOK_TANGO_TEXT_HEADER_1
!! vim: noautoindent noexpandtab tabstop=8 shiftwidth=8 filetype=tsv fileencoding=sjis fileformat=dos
!! ==============================================
!! Strinova 日本語辞書（ATOK向け）
!! ==============================================
!! 読み	単語	品詞	単語コメント	自動置換	置換候補1..5
すとりのう゛ぁ	ストリノヴァ	固有商品	TPSゲーム	しない	Strinova
!! キャラ
ちよ	千代	固有人他	Strinova
まーらー	マーラー	固有人他	Strinova
れおな	レオナ	固有人他	Strinova
!! 読み方がはっきりしないため2件追加
ゆうぎり	夕霧	固有人他	Strinova
ゆぎり	夕霧	固有人他	Strinova
がらてあ	ガラテア	固有人他	Strinova
みしぇる	ミシェル	固有人他	Strinova
!! English版の読み
みん	明	固有人他	Strinova
まだれーな	マダレーナ	固有人他	Strinova
いう゛ぇっと	イヴェット	固有人他	Strinova
めれでぃす	メレディス	固有人他	Strinova
ここな	心夏	固有人他	Strinova
らう゛ぃーね	ラヴィーネ	固有人他	Strinova
おーどりー	オードリー	固有人他	Strinova
のぶなが	信長	固有人他	Strinova
れいいち	令一	固有人他	Strinova
ふゅーしゃ	フューシャ	固有人他	Strinova
ふらう゛ぃあ	フラヴィア	固有人他	Strinova
かなみ	香菜美	固有人他	Strinova
!! English版の読み
ばいも	白墨	固有人他	Strinova
あいか	アイカ	固有人他	Strinova
ふらぐらんす	フラグランス	固有人他	Strinova
!! 晶原体
しょうげんたい	晶原体	固有名詞	Strinova
ばくれつのようま	爆裂の妖魔	固有人他	Strinova
かまづめのまじゅう	鎌爪の魔獣	固有人他	Strinova
!! 読み不明: 血棘の皇女
!! 読み不明: 冥棘の皇女
!! マップ
404きち	404基地	固有地名	Strinova
88く	88区	固有地名	Strinova
オイラーこう	オイラー港	固有地名	Strinova
うぃんでぃたうん	ウィンティタウン	固有地名	Strinova
うぃんでぃーたうん	ウィンティータウン	固有地名	Strinova ×ウィンディー ○ウィンディ	ウィンディタウン
すぺーすけんきゅうせんたー	スペース研究センター	固有地名	Strinova
こーしーがいく	コーシー街区	固有地名	Strinova
きすめっと	キスメット	固有地名	Strinova
2ごうそうこ	2号倉庫	固有地名	Strinova
でざいなーずといぱーく	デザイナーズトイパーク	固有地名	Strinova
すいちゅうはつでんしょ	水中発電所	固有地名	Strinova
みなとまち	港町	固有地名	Strinova
!! 花明弓道場は読み不明で未収録
ついほうち	追放地	固有地名	Strinova
あくさこうじょう	アクサ工場	固有地名	Strinova
せつげんひがしく	雪原・東区	固有地名	Strinova
せつげん・ひがしく	雪原・東区	固有地名	Strinova
おるかぬす	オルカヌス	固有地名	Strinova
てふ・おあしす	テフ・オアシス	固有地名	Strinova
えれいどどうくつ	エレイド洞窟	固有地名	Strinova
ろっしゅちく	ロッシュ地区	固有地名	Strinova
がーないせき	ガーナ遺跡	固有地名	Strinova
きょくちけんきゅうじょ	極地研究所	固有地名	Strinova
おいらーやこう	オイラー夜港	固有地名	Strinova
しんくのはいきょ	深紅の廃墟	固有地名	Strinova
らいときゃんぱす	ライトキャンパス	固有地名	Strinova
でぃらっくこうざん	ディラック鉱山	固有地名	Strinova
!! 武器
いんすぺくたー	インスペクター	固有商品	Strinova
じゃっじ	ジャッジ	固有商品	Strinova
くえーさー	クエーサー	固有商品	Strinova
ふろすと	フロスト	固有商品	Strinova
そろだんす	ソロダンス	固有商品	Strinova
ふぁるこん	ファルコン	固有商品	Strinova
りばーすふれいむ	リバースフレイム	固有商品	Strinova
しゃどうあさると	シャドウアサルト	固有商品	Strinova
どーん	ドーン	固有商品	Strinova
ふぃなーれ	フィナーレ	固有商品	Strinova
そのらすふぁいあ	ソノラスファイア	固有商品	Strinova
そーとぅーす	ソートゥース	固有商品	Strinova
ぽらりす	ポラリス	固有商品	Strinova
ちゃんぴおん	チャンピオン	固有商品	Strinova
ふりーうぃる	フリーウィル	固有商品	Strinova
くろま	クロマ	固有商品	Strinova
ぶろっさむ	ブロッサム	固有商品	Strinova
とりっくすたー	トリックスター	固有商品	Strinova
えんふぉーさー	エンフォーサー	固有商品	Strinova
きゃりぶれーた	キャリブレータ	固有商品	Strinova
ですさいす	デスサイス	固有商品	Strinova
かえで	カエデ	固有商品	Strinova
!! サブ武器
みつばち	みつばち	固有商品	Strinova
!! English版の読み
にんじゃとう	忍刀	固有商品	Strinova
えんばーすぴっと	エンバースピット	固有商品	Strinova
あてな	アテナ	固有商品	Strinova
いぐにす	イグニス	固有商品	Strinova
!! 戦術アイテム（一般的な物は省略）
いんたーせぷたー	インターセプター	固有商品	Strinova
げんそくぼむ	減速ボム	固有商品	Strinova
ふうらいぼむ	風雷ボム	固有商品	Strinova
!! その他用語
げんか	弦化	名詞サ変	Strinova
